border_size=1
usage=map

Ww          , Ww          , Gg          , Gg          , Gg          , Gs          , Gg          , Gs          , Gs          , Re          , Hh          , Hh          , Hh          , Mm          , Mm          , Hh          , Hh          , Hh          , Mm          , Mm          , Md          , Mm          , Hhd         , Gd          , Hhd         , Hhd         , Hhd         , Hhd         , Hhd         , Gd          , Gd          , Gd          , Gd          , Md          , Md          , Gd          , Hhd         , Gd          , Hhd         , Gd          , Hhd         
Ss          , Ss          , Gg          , Gg          , Gs          , Gg          , Gs          , Gg          , Gs          , Re          , Gs          , Hh          , Hh          , Mm          , Hh          , Hh          , Gs          , Mm          , Hhd         , Md          , Md          , Md          , Gd          , Md          , Hhd         , Hhd         , Md          , Md          , Gd          , Hhd         , Gd          , Hhd         , Md          , Gd          , Gd          , Hhd         , Gd          , Md          , Md          , Md          , Md          
Gg          , Gg          , Hh          , Hh          , Hh          , Hh          , Gs          , Gs          , Gs          , Re          , Hh          , Hh          , Hh          , Gs          , Mm          , Mm          , Hh          , Mm          , Md          , Md          , Md          , Md          , Md          , Md          , Gd          , Md          , Md          , Md          , Hhd         , Md          , Md          , Md          , Md          , Md          , Md          , Hhd         , Md          , Md          , Md          , Md          , Md          
Gg          , Hh          , Hh          , Gs          , Gs          , Hh          , Hh          , Gs          , Re          , Re          , Gs          , Hh          , Hh          , Gs          , Mm          , Gs          , Md          , Md          , Gs          , Hhd         , Hhd         , Hhd         , Hhd         , Md          , Md          , Md          , Gd          , Md          , Hhd         , Gd^Dr       , Md          , Md          , Md          , Md          , Md          , Gd          , Md          , Md          , Hhd         , Hhd         , Md          
Gg          , Gs          , Gs          , Hh          , Gs          , Hh          , Gs          , Hh          , Re          , Hh          , Gs          , Gs          , Mm          , Mm          , Mm          , Hh          , Md          , Hhd         , Md          , Md          , Md          , Md          , Gd          , Hhd         , Hhd         , Gd          , Md          , Md          , Md          , Md          , Gd          , Md          , Md          , Md          , Md          , Gd          , Md          , Md          , Hhd         , Md          , Md          
Gs          , Gg          , Mm          , Hh          , Gs          , Gs          , Gs          , Mm          , Re          , Hh          , Hh          , Hh          , Hh          , Mm          , Mm          , Mm          , Md          , Gs          , Gd          , Gd          , Md          , Md          , Md          , Md          , Hhd         , Gd          , Hhd         , Gd          , Md          , Md          , Md          , Gd          , Md          , Hhd         , Hhd         , Md          , Md          , Hhd         , Md          , Md          , Gd          
Gs          , Gs          , Gs          , Gs          , Gs          , Mm          , Hh          , Gs          , Re          , Mm          , Gs          , Hh          , Hh          , Gs          , Md          , Md          , Gd          , Hhd         , Hhd         , Gd          , Gd          , Md          , Hhd         , Md          , Md          , Md          , Gd          , Md          , Hhd         , Hhd         , Hhd         , Md          , Md          , Hhd         , Gd          , Hhd         , Md          , Md          , Md          , Md          , Hhd         
Gg          , Hh          , Hh          , Hh          , Hh          , Hh          , Mm          , Mm          , Re          , Gs          , Mm          , Gs          , Md          , Md          , Gd          , Md          , Hhd         , Gd          , Md          , Md          , Md          , Md          , Md          , Md          , Hhd         , Hhd         , Md          , Hhd         , Md          , Md          , Md          , Gd          , Hhd         , Md          , Hhd         , Hhd         , Hhd         , Md          , Md          , Md          , Hhd         
Gg          , Mm          , Mm          , Mm          , Gs          , Hh          , Mm          , Re          , Mm          , Hh          , Hh          , Md          , Hhd         , Md          , Gd          , Md          , Md          , Md          , Gd          , Md          , Hhd         , Md          , Hhd         , Gd          , Hhd         , Hhd         , Hhd         , Hhd         , Hhd         , Gd          , Hhd         , Hhd         , Md          , Gd          , Md          , Md          , Md          , Hhd         , Md          , Md          , Md          
Hh          , Hh          , Gs          , Hh          , Mm          , Hh          , Mm          , Re          , Mm          , Md          , Hh          , Md          , Md          , Md          , Md          , Md          , Md          , Md          , Md          , Hhd         , Hhd         , Gd          , Gd          , Hhd         , Hhd         , Gd          , Gd          , Hhd         , Hhd         , Hhd         , Gd^Edpp     , Hhd         , Gd          , Hhd         , Gd          , Hhd         , Md          , Gd^Es       , Gd          , Md          , Md          
Gg          , Hh          , Gs          , Hh          , Gd          , Hh          , Hh          , Re          , Rd          , Gs          , Md          , Hhd         , Md          , Hhd         , Md          , Md          , Md          , Md          , Hhd         , Hhd         , Gd          , Gd          , Gd^Es       , Hhd         , Gd          , Gd          , Hhd         , Hhd         , Gd          , Hhd         , Gd          , Gd          , Gd          , Hhd         , Gd          , Gd          , Gd          , Md          , Hhd         , Gd          , Hhd         
Gg          , Gg          , Gs          , Hh          , Gs          , Gs          , Gs          , Gd          , Gs          , Re          , Md          , Md          , Hhd         , Md          , Hhd         , Hhd         , Hhd         , Hhd         , Hhd         , Hhd         , Gd^Es       , Gs          , Gd          , Hhd         , Hhd         , Gd          , Gd          , Hhd         , Gd          , Gd^Es       , Gd          , Hhd         , Gd^Es       , Gd          , Hhd         , Hhd         , Hhd^Vhhr    , Hhd         , Hhd         , Md          , Md          
Mm          , Gs          , Gs          , Gs          , Gs          , Gs          , Gs          , Mm          , Gd          , Re          , Rd          , Hhd         , Hhd         , Md          , Md          , Gd          , Gd          , Hhd         , Gd          , Hhd         , Gd          , Gd          , Gd          , Hhd         , Hhd         , Hhd         , Hhd         , Hhd         , Hhd         , Gd          , Gd          , Gd          , Gd          , Gd          , Hhd         , Hhd         , Md          , Hhd         , Md          , Md          , Hhd         
Hh          , Gs          , Gs          , Gs          , Gs          , Gs          , Mm          , Gs          , Gd          , Gd          , Re          , Hhd         , Md          , Md          , Hhd         , Md          , Hhd         , Gd          , Gd          , Gd          , Gd          , Gd          , Rd          , Hhd         , Rd          , Hhd         , Rd          , Gd          , Gd          , Gd          , Gd          , Hhd         , Gd          , Hhd         , Hhd         , Md          , Md          , Md          , Gd          , Md          , Hhd         
Hh          , Mm          , Mm          , Mm          , Mm          , Gs          , Mm          , Gd          , Gs          , Gd          , Rd          , Hhd         , Md          , Hhd         , Md          , Hhd         , Hhd         , Gd          , Rd          , Rd          , Rd          , Rd          , Gd          , Rd          , Hhd         , Rd          , Md          , Rd          , Rd          , Gd          , Gd^Es       , Gd          , Gd          , Gd          , Hhd         , Gd          , Md          , Gd^Es       , Md          , Md          , Hhd         
Ms          , Mm          , Mm          , Hh          , Hh          , Hh          , Md          , Gd          , Gd          , Gd          , Gd          , Rd          , Rd          , Hhd         , Rd          , Gd          , Rd          , Rd          , Hhd         , Hhd         , Gd          , Hhd         , Gd          , Gd          , Gd          , Gd          , Md          , Gd          , Hhd         , Rd          , Rd          , Gd          , Gd          , Gd          , Gd          , Hhd         , Hhd         , Md          , Gd          , Md          , Md          
Mm          , Ms          , Ms          , Mm          , Mm          , Hhd         , Gs          , Hh          , Hhd         , Gd          , Hhd         , Hhd         , Hhd^Vhhr    , Rd          , Gd          , Rd          , Gd          , Hhd         , Hhd         , Md          , Gd          , Gd          , Hhd         , Md          , Md          , Hhd         , Hhd         , Hhd         , Hhd         , Gd          , Md          , Rd          , Rd          , Gd          , Gd          , Hhd         , Md          , Md          , Gd          , Md          , Hhd         
Gg          , Mm          , Ms          , Ms          , Mm          , Hh          , Md          , Gd          , Gd          , Gd          , Hhd         , Md          , Gs          , Gd          , Hhd         , Gd          , Gd          , Hhd         , Md          , Md          , Hhd         , Gd^Es       , Gd          , Hhd^Vhhr    , Md          , Md          , Hhd         , Gd          , Gd          , Gd          , Hhd         , Gd          , Gd          , Rd          , Rd          , Gd          , Hhd         , Md          , Gd          , Md          , Md          
Gg          , Mm          , Mm          , Ms          , Ms          , Gs          , Md          , Md          , Gd          , Gs          , Gs          , Gd          , Md          , Hhd         , Md          , Gd          , Hhd         , Hhd         , Hhd         , Md          , Hhd         , Gd          , Hhd         , Hhd         , Md          , Md          , Gd          , Md          , Gd          , Hhd         , Hhd         , Gd          , Hhd         , Hhd         , Rd          , Gd          , Gd          , Gd          , Md          , Md          , Md          
Gg          , Gg          , Mm          , Mm          , Ms          , Mm          , Ms          , Md          , Md          , Gd          , Gd          , Hhd         , Md          , Hhd         , Gd          , Gd          , Hhd         , Md          , Md          , Hhd         , Md          , Md          , Md          , Md          , Md          , Md          , Md          , Md          , Md          , Md          , Hhd         , Gd          , Hhd         , Gd          , Hhd         , Rd          , Rd          , Gd          , Gd          , Hhd         , Md          
Gg          , Hh          , Hh          , Mm          , Gg          , Ms          , Ms          , Md          , Md          , Md          , Gd          , Md          , Md          , Hhd         , Hhd         , Md          , Md          , Hhd         , Md          , Md          , Md          , Hhd         , Hhd         , Hhd         , Md          , Hhd         , Md          , Md          , Md          , Md          , Md          , Md          , Hhd         , Hhd         , Hhd         , Hhd         , Rd          , Hhd         , Hhd         , Hhd         , Hhd         
Hh          , Hh          , Hh          , Mm          , Mm          , Mm          , Ms          , Gs          , Md          , Md          , Md          , Md          , Hhd         , Hhd         , Md          , Gd          , Md          , Md          , Md          , Hhd         , Hhd         , Gd          , Gd          , Gd          , Gd          , Gd          , Md          , Md          , Md          , Hhd         , Hhd         , Hhd         , Md          , Md          , Hhd         , Hhd         , Gd          , Rd          , Gd^Esd      , Hhd         , Hhd         
Hh          , Gg          , Gg          , Gg          , Gg          , Mm          , Gg          , Ms          , Md          , Md          , Md          , Md          , Md          , Md          , Hhd         , Md          , Md          , Mm          , Gd          , Hhd         , Gd          , Gd          , Gd          , Gd^Es       , Gd          , Gd          , Hhd         , Hhd         , Hhd         , Hhd         , Gd          , Hhd         , Md          , Md          , Md          , Hhd         , Hhd         , Rd          , Gd^Esd      , Dd          , Hhd         
Hh          , Mm          , Mm          , Mm          , Gg          , Mm          , Mm          , Ms          , Md          , Ms          , Md          , Md          , Md          , Gd          , Gd          , Hhd         , Gd          , Hhd         , Gd^Es       , Hhd         , Gd          , Gd          , Hhd         , Gd          , Hhd         , Gd          , Gd          , Gd          , Md          , Gd          , Hhd         , Hhd         , Md          , Md          , Hhd         , Hhd         , Gd          , Rd          , Gd          , Gd          , Gd^Esd      
Hh          , Hh          , Mm          , Mm          , Mm          , Mm          , Mm          , Ms          , Ms          , Md          , Md          , Md          , Gd          , Gd          , Gd          , Gd          , Hhd         , Gd          , Gd          , Hhd         , Hhd         , Gd          , Gd          , Gd          , Gd          , Hhd         , Gd          , Gd          , Hhd         , Hhd         , Md          , Md          , Md          , Hhd         , Ce          , 1 Ke        , Ce          , Rd          , Gd          , Gd          , Hhd         
Hh          , Hh          , Mm          , Hh          , Mm          , Hh          , Hh          , Ms          , Ms          , Gd          , Md          , Md          , Hhd         , Gd          , Md          , Gd          , Gd          , Gd          , Md          , Gd          , Gd          , Gd          , Gd          , Mm          , Gd          , Gd          , Gd          , Gd          , Md          , Hhd         , Hhd         , Hhd^Vhhr    , Hhd         , Hhd         , Hhd         , Ce          , Gd          , Rd          , Gd          , Hhd         , Hhd         
Gg          , Hh          , Mm          , Hh          , Mm          , Mm^Xm       , Ms          , Hhd         , Hhd^Vhhr    , Hhd         , Gd          , Gd          , Hhd         , Hhd         , Hhd         , Gd          , Gd          , Hhd         , Gd          , Gd          , Gd          , Hhd         , Hhd         , Gd          , Md          , Hhd         , Hhd         , Gd          , Gd          , Hhd         , Md          , Gd          , Hhd         , Hhd         , Hhd         , Hhd         , Rd          , Rd          , Hhd         , Gd^Edpp     , Hhd         
Gg          , Mm          , Mm          , Mm^Xm       , Mm^Xm       , Hh          , Gd          , Hhd         , Hhd         , Hhd         , Hhd         , Hhd         , Gd          , Gd          , Gd          , Hhd         , Hhd         , Gd          , Gd          , Hhd         , Hhd         , Gd          , Hhd         , Gd          , Hhd         , Gd          , Gd          , Gd          , Gd          , Md          , Hhd         , Md          , Md          , Hhd         , Rd          , Rd          , Gd          , Gd          , Gd          , Hhd         , Gd          
Gg          , Mm          , Mm^Xm       , Hhd         , Gd          , Hhd         , Gd          , Hhd         , Gd          , Hhd         , Gd          , Gd          , Gd^Es       , Gd^Edp      , Gd          , Hhd         , Hhd         , Hhd         , Gd          , Hhd         , Gd          , Gd          , Gd          , Hhd         , Gd          , Hhd         , Gd          , Gd          , Gd          , Md          , Hhd         , Hhd         , Rd          , Rd          , Hhd         , Gd          , Gd          , Gd          , Hhd         , Hhd         , Hhd         
Hh          , Md          , Mm^Xm       , Hhd         , Hhd         , Hhd         , Hhd         , Gd          , Hhd         , Gd          , Gd          , Gd          , Gs          , Gd          , Gd          , Gd          , Gd          , Gd^Es       , Gd          , Gd          , Gd          , Hhd         , Gd          , Gd          , Gd          , Hhd         , Gd          , Gd          , Gd          , Md          , Rd          , Rd          , Gd          , Hhd         , Hhd         , Hhd         , Gd          , Gd          , Gd          , 3 Hhd       , Md          
Md          , Mm^Xm       , Mm          , Hhd         , Hhd         , Gd          , Gd^Es       , Gd          , Gd          , Gd^Es       , Gd          , Hhd         , Gd^Edp      , Gd          , Gd          , Gd          , Gd          , Gd          , Gd          , Gd          , Gd          , Gd          , Gd          , Gd^Es       , Gd          , Gd          , Gd          , Gd          , Gd          , Gd          , Rd          , Md          , Md          , Hhd         , Gd          , Gd          , Hhd         , Gd          , Gd          , Gd          , Gd          
Hh          , Mm^Xm       , Mm          , Hhd         , Gs          , Gd          , Hhd         , Gd          , Gs          , Hhd         , Gd          , Gs          , Gd          , Gd          , Rd          , Gd          , Rd          , Gd          , Rd          , Rd          , Rd          , Rd          , Rd          , Rd          , Rd          , Rd          , Rd          , Rd          , Rd          , Rd          , Gd          , Hhd         , Hhd         , Md          , Hhd         , Gd          , Hhd         , Gd          , Mm          , Gd          , Gd          
Hh          , Mm^Xm       , Mm          , Gs          , Hhd         , Hhd         , Gd          , Gd          , Gd^Es       , Gd          , Gd          , Gd          , Rd          , Rd          , Ce          , Rd          , Rd          , Rd          , Hhd         , Gd          , Gd          , Gd          , Gd          , Gd          , Gd          , Hhd         , Hhd         , Gd          , Hhd         , Gd          , Gd          , Gd          , Gd          , Hhd         , Gd          , Gd          , Mm          , Hhd         , Mm          , Mm          , Gd          
Mm^Xm       , Mm^Xm       , Hhd         , Hhd         , Hhd         , Hhd         , Gd          , Gs          , Gd          , Gd          , Rd          , Rd          , Ce          , Ce          , Ce          , Hhd         , Rd          , Hhd         , Hhd         , Hhd         , Gd          , Gd^Es       , Gd          , Gd          , Gd          , Hhd         , Gd          , Hhd         , Gd          , Gd          , Gd          , Gd          , Gd          , Hhd         , Hhd         , Hhd         , Hhd         , Gd          , Mm          , Mm          , Md          
Mm          , Mm          , Mm          , Gd          , Gs          , Hhd         , Gd          , Gd          , Rd          , Rd          , Hhd         , Hhd         , Gs          , 2 Ke        , Gd^Edpp     , Gd          , Rd          , Hhd         , Md          , Hhd         , Hhd         , Hhd^Vhhr    , Hhd         , Hhd         , Hhd         , Gd          , Gd          , Gd          , Gd          , Gd          , Gd          , Hhd         , Gd          , Hhd         , Gd          , Hhd         , Hhd         , Hhd         , Mm          , Hhd         , Md          
Mm^Xm       , Mm          , Mm          , Hhd         , Hhd         , Gd^Es       , Gd          , Rd          , Gd          , Hhd         , Md          , Md          , Gd^Es       , Md          , Gd^Es       , Gd          , Rd          , Gd          , Md          , Gd          , Md          , Hhd         , Md          , Md          , Md          , Hhd         , Gd          , Gd          , Gd          , Md          , Gd          , Hhd         , Gd          , Gd          , Hhd         , Mm          , Gd          , Gd          , Gd          , Mm          , Mm          
