border_size=1
usage=map

Gs, Rb, Rb, Gg, Gg, Hh, Mm, Gg, Mm, Mm, Mm, Mm, Ms, Ms, Ms, Ms, Mm, Mm, Mm, Hh, Mm, Gg, Mm, Mm, Mm, Rb, Md, Gg, Md, Md, Ms, Ms, Ms, Ms, Ha, Ai, Wot, Ww, Mm, Ms, Mm, Hh, Hh, Mm, Gg, Gs
Hh, Gs, Gg, Re, Re, Hh, Hh, Mm, Mm, Mm, Mm, Mm, Ms, Mm, Ms, Ms, Ms, Mm, Mm, Mm, Mm, Mm, Mm, Mm, Mm, Rb, Md, Md, Gg, Md, Md, Ms, Mm, Md, Hh, Wot, Wot, Mm, Hh, Mm, Gg, Hh, Hh, Gs, Rb, Rb
Hh, Gg, Rb, Re, Gg, Re, Ch, Ch, Mm, Mm, Ms, Ms, Ms, Ms, Mm, Ms, Mm, Mm, Mm, Mm, Mm, Mm, Mm, Mm, Gg, Re, Hh, Md, Md, Gg, Gs, Hh, Hh, Hh, Gg, Wot, Wot, Hh, Gs, Hh, Gs, Gs, Gg, Re, Hh, Mm
Mm, Rb, Mm^Xm, Mm, Mm, Hh, Ch, 2 Kh, Gg^Efm, Mm, Ms, Ms, Mm, Mm, Mm, Mm, Mm, Mm, Mm, Mm, Mm, Mm, Mm, Hh, Gs, Re, Gs, Gg, Hh, Gs, Gg, Gg, Gg, Gs, Mm, Hh, Wot, Ww, Gg, Gg, Gs, Gg, Re, Re, Hh, Mm
Hh, Re, Rb, Mm^Xm, Mm^Xm, Hh, Mm, Ch, Mm, Mm, Mm, Ms, Ms, Mm, Mm, Mm, Mm, Mm, Mm, Mm, Mm, Mm, Mm, Mm, Mm, Re, Gg, Gs, Gg, Hh, Gg, Gs, Gg, Gs, Gg, Gg, Ww, Wot, Wot, Gg, Rb, Re, Gg, Gs, Hh, Gg
Mm, Mm, Rb, Mm, Mm^Xm, Mm, Ms^Xm, Ms, Mm^Xm, Ms^Xm, Mm^Xm, Ms^Xm, Mm^Xm, Mm, Mm^Xm, Mm, Mm, Mm, Hh, Mm, Mm, Mm, Mm, Mm, Mm, Re, Rb, Gs, Gg, Gg, Gs, Gg, Gg, Hh, Re, Gg, Gg, Wot, Wot^Bw/r, Wot, Wot, Gs, Gs, Hh, Hh, Mm
Hh, Rb, Mm, Gg, Mm^Xm, Ms^Xm, Ms^Xm, Ms^Xm, Mm, Mm, Mm, Mm, Mm, Mm^Xm, Mm, Mm^Xm, Mm^Xm, Mm, Mm, Mm, Mm, Hh, Mm, Mm, Mm, Gg, Hh, Re, Rb, Rb, Rb, Re, Rb, Re, Gg, Re, Re, Rb, Gg, Wot, Wot, Gg, Gg, Gs, Gg, Hh
Hh, Re, Gs, Hh, Ms^Xm, Mm, Ms, Ms, Mm, Mm, Mm, Mm, Gg, Mm, Gg, Mm, Mm^Xm, Mm, Mm, Mm, Hh, Mm, Mm, Mm, Mm, Mm, Hh, Rb, Sm, Wo, Hh, Gs, Gs, Gg, Gs, Gs, Gg, Gs, Gg, Wot, Wot, Gg, Wwf, Gs, Ww, Gg
Hh, Re, Mm, Ms^Xm, Mm^Xm, Ms, Ms, Ms, Ce, Mm, Gg, Hh, Hh, Hh, Hh, Mm, Mm^Xm, Mm, Mm, Mm, Hh, Gg, Hh, Mm, Mm, Mm, Mm, Rb, Rb, Wo, Wo, Gg, Gg, Gg, Gg^Efm, Gs, Gg, Gg, Gg, Wot, Wot, Gg, Wwf, Wot, Ww, Wot
Mm, Re, Mm, Ms^Xm, Mm, Ms, Ms, 3 Kea, Ce, Ce, Gg, Gs, Gg, Gs, Gs, Hh, Mm^Xm, Hh, Hh, Hh, Gg, Gg, Gs, Mm, Mm, Mm, Mm, Mm, Mm, Rb, Rb, Wot, Wot, Wot, Wot, Wot, Gg, Gs, Wwf, Gg, Wot, Wot, Ww, Wot, Ww, Wot
Hh, Re, Mm, Ms^Xm, Mm^Xm, Mm, Mm, Mm, Gs, Gg, Gg, Gs, Gg, Gg, Gg, Hh, Mm, Mm^Xm, Hh, Hh, Gs, Gs, Hh, Gg, Mm, Mm, Mm, Mm, Mm, Mm, Rb, Wot, Wot, Wot, Wot, Gg, Gg, Gg, Wot, Wwf, Ww, Wot, Wwf, Ww, Ww, Ww
Rb, Re, Mm, Mm^Xm, Mm^Xm, Mm, Mm, Hh, Gg, Gs, Hh, Gg, Gg, Gs, Gg, Gs, Gg, Mm^Xm, Hh, Gg, Gs, Gg, Gg, Hh, Hh, Mm, Mm, Mm, Rb, Rb, Wot, Wot, Wot, Ww, Ww, Wot, Wwf, Wot, Wot, Wot, Ww, Ww, Ww, Ww, Wot, Wot
Hh, Re, Re, Mm, Gg, Mm^Xm, Mm^Xm, Mm, Mm, Gg, Hh, Gg, Mm, Hh, Hh, Gs, Gg, Gg, Gg, Gs, Gg, Gg, Gg, Hh, Rb, Hh, Re, Re, Gg, Wot, Wot, Wot, Wot, Wot, Wot, Ww, Wwf, Wot, Wot, Wot, Wwf, Wot, Wot, Wot, Wot, Wot
Mm, Mm, Hh, Rb, Re, Mm, Hh, Mm^Xm, Mm^Xm, Mm, Hh, Mm, Mm^Xm, Hh, Mm^Xm, Mm^Xm, Gg, Gs, Gg, Gs, Gg, Gs, Re, Re, Gs, Re, Gg, Gs, Wot, Wot, Wot, Wot, Wot, Ww, Ww, Ww, Ww, Ww, Ww, Ww, Ww, Wwf, Gg, Gs, Gg, Gs
Hh, Mm, Hh, Mm, Re, Mm, Mm, Hh, Mm^Xm, Mm, Mm^Xm, Mm^Xm, Hh, Mm^Xm, Gg, Gg, Gs, Gg, Gg, Gg, Rb, Re, Gs, Gg, Gg, Gs, Gg, Gg, Wot, Wot, Wot, Wot, Wot, Wot, Wot, Wwf, Wot, Ww, Wot, Wot, Gg, Gg, Gg, Gg, Gg, Gg^Efm
Hh, Mm, Mm, Gg, Mm, Rb, Gg, Gg, Hh, Mm^Xm, Mm^Xm, Mm, Mm, Hh, Hh, Gg, Gg, Gg, Rb, Rb, Gg, Gg, Gg, Gg, Gg, Gg, Gg, Gg, Wot, Wot, Wot, Gg, Wwf, Ww, Wot, Wot, Wot, Wot, Wot, Wot, Gg, Gg, 1 Gg, Ss, Gg^Efm, Sm
Hh, Hh, Mm, Mm, Gg, Rb, Gs, Gs, Hh, Hh, Mm, Mm, Hh, Mm, 6 Kh, Hh, Gg, Gg, Rb, Ss, Ss, Gg, Gg, Ss, Gg, Gg, Gg, Gg, Wot, Wot, Wot, Gg, Wot, Ww, Ww, Ww, Wwf, Wot, Wot, Wot, Ds, Gs, Gg, Gg, Gg, Gg
Hh, Mm, Hh, Mm, Hh, Re, Re, Gg, Mm, Mm, Mm, Hh, Hh, Mm, Ch, Ch, Re, Rb, Gg, Gg, Gg, Ss, Ss, Ss, Ss, Ss, Gg, Gg, Wot, Wot, Wot, Wot, Wot, Wot, Ww, Ww, Wwf, Ww, Wot, Wot, Ds, Gs, Ss, Gg, Gg, Ss
Mm, Mm, Hh, Hh, Gg, Hh, Re, Hh, Mm, Mm, Mm, Mm, Mm, Mm, Re, Re, Gs, Gg, Gg, Gg, Gg, Gg, Gg, Gg, Ss, Gg, Gg, Gg, Ss, Wot, Ww, Ww, Ww, Wwf, Ww, Ww, Ww, Ww, Wot, Ds, Gs, Gg, Gg, Ss, Gg, Gg
Gg, Mm, Mm, Gg, Hh, Hh, Rb, Mm, Wo, Mm, Mm, Mm, Gg, Rb, Gg, Gg, Gg, Gg, Gg, Gg, Gg, Ss, Gg, Gg, Gg, Ss, Ss, Gg, Sm, Gg, Gg, Wwf, Ww, Wot, Wot, Ww, Ww, Wot, Wot, Wot, Wot, Gg, Gs, Gg, Wot, Wot
Hh, Gg, Hh, Mm, Mm, Gg, Re, Mm, Mm, Mm, Mm, Hh, Rb, Re, Gs, Gg, Gg, Gg, Gg, Gg, Ss, Gg, Gg, Ss, Gg, Gg, Ss, Gg, Ss, Ss, Gg, Ww, Wot, Ww, Ww, Wwf, Wot, Wot, Ww, Wot, Wot, Gg, Ww, Wot, Ww, Wot
Mm, Hh, Mm, Mm, 5 Kh, Mm, Mm, Re, Mm, Hh, Re, Rb, Gg, Gs, Gs, Gg, Gg, Gs, Gg, Gg, Ss, Gg, Gg, Ss, Gg, Ss, Gg, Gg, Ss, Gg, Ww, Ww, Wo, Wo, Wot, Wot, Wot, Ww, Wot, Ww, Wot, Wot, Wot, Wot, Wot, Ww
Mm, Mm, Mm, Mm, Ch, Ch, Re, Re, Re, Re, Gs, Gg, Gs, Gg, Gg, Gs, Gg, Gg, Gg, Gg, Gg, Gg, Wo, Gg, Ss, Gg, Ww, Wo, Ww, Wo, Ww, Ww, Gg, Gg, Ss, Wot, Wot, Wot, Ss, Wot, Wot, Ww, Wot, Wot, Wot, Wot
Re, Rb, Re, Rb, Re, Re, Re, Re, Rb, Gg, Gs, Gs, Gg, Gg, Gg, Gg, Gg, Gg, Gg, Gg, Ww, Wo, Ww, Ww, Ww, Ww, Gg, Ww, Ss, Ww, Ss, Ds, Gg, Ss, Ss, Gg, Ss, Wot, Ww^Ewl, Wot, Ss, Wo, Ww, Wot, 4 Khw, Wot
Hh, Mm, Mm, Mm, Mm, Mm, Hh, Hh, Re, Gg, Gg, Gs, Gs, Gg, Gg, Gg, Gg, Gg, Ww, Ww, Wo, Ww, Ss, Gg, Gg, Gg, Gg, Gg, Gg, Gg, Gg, Ss, Ss, Ss, Gg, Gg, Ss, Gg, Ss, Ss, Ww, Ww, Chw, Chw, Chw, Ww
Hh, Mm, Mm, Mm, Mm, Hh, Gs, Gs, Gs, Re, Gg, Gg, Gg, Gg, Ww, Wo, Ww, Ww, Ww, Ww, Gg, Gg, Gg, Gg, Ss, Gg, Gg, Ss, Ss, Gg^Efm, Ss, Gg, Ss, Ss, Ss, Ss, Gg, Gg, Gg^Efm, Gg, Ww, Ww, Ss, Ss, Ww, Ww
Mm, Mm, Ms, Hh, Mm, Mm, Gg, Hh, Gg, Rb, Gg, Gg, Ww, Ww, Ww, Ww, Gg, Wo, Gg, Gg, Gs, Gg, Gg, Gg, Gg, Ss, Gg, Ss, Ss, Ss, Ss, Gg, Gg, Gg, Ss, Gg, Ss, Ss, Sm, Ss, Ss, Ww, Ss, Ww, Ww, Ww
Mm, Ms, Ww, Ms, Mm, Mm, Hh, Hh, Gg, Rb, Rb, Gg, Ww, Ww, Gg, Gg, Gg, Gg, Gg, Gs, Gg, Gg, Gg, Gg, Ss, Gg, Ss, Ss, Gg, Gg, Ss, Mm, Mm^Xm, Hh, Ss, Hh, Ss, Ss, Gg, Ss, Gg, Ss, Ss, Ss, Ss, Ww
Wo, Wo, Mm, Ms, Mm, Mm, Mm, Gg, Mm, Gg, Wwf, Wwf, Wwf, Ww, Gg, Gs, Gg, Hh, Gg, Gg, Gg, Gg, Hh, Gg, Gg, Ss, Gg, Gg, Hh, Ss, Mm^Xm, Mm^Xm, Mm, Mm^Xm, Mm^Xm, Ss, Hh, Ss, Ss, Gg, Ss, Ss, Hh, Ss, Hh^Fp, Gg
Ww, Wo, Wo, Mm, Mm, Mm, Mm, Mm, Mm, Wo, Ww, Wwf, Rb, Ch, Hh, Gg, Hh, Hh, Mm, Hh, Gg, Gg, Hh, Gg, Gg, Gg, Mm, Gg, Mm^Xm, Hh, Mm^Xm, Mm, Hh, Hh, Mm^Xm, Hh, Mm^Xm, Gg, Hh, Mm, Mm^Xm, Hh, Mm^Xm, Gg, Mm^Xm, Gg
Gg, Wo, Wo, Ww, Mm^Xm, Hh, Hh, Gg, Mm^Xm, Ww, Ww, Ch, Kh, Rb, Mm, Mm, Mm^Xm, Mm, Mm^Xm, Mm, Gg, Mm, Mm^Xm, Hh, Mm^Xm, Gg, Gg, Mm^Xm, Mm^Xm, Mm^Xm, Hh, Hh, Hh, Mm, Mm^Xm, Mm^Xm, Hh, Mm^Xm, Mm^Xm, Gg, Hh, Mm^Xm, Mm^Xm, Mm^Xm, Hh^Fp, Mm^Xm
Mm^Xm, Mm^Xm, Mm^Xm, Mm^Xm, Mm^Xm, Mm^Xm, Mm^Xm, Mm^Xm, Mm, Ww, Wo, Mm, Hh, Rb, Mm, Mm^Xm, Mm, Mm^Xm, Mm, Mm^Xm, Gg, Mm^Xm, Mm, Mm^Xm, Mm^Xm, Mm^Xm, Mm^Xm, Gg^Efm, Hh, Hh, Mm^Xm, Mm^Xm, Mm^Xm, Gg, Hh, Gg, Gg, Mm, Mm, Mm^Xm, Mm^Xm, Hh, Gg^Efm, Hh, Gg, Hh
Hh, Mm^Xm, Hh, Hh^Fp, Mm, Hh, Mm, Mm, Ww, Ww, Gg^Efm, Mm, Mm, Re, Gg, Mm, Hh^Fp, Wo, Mm, Mm, Gg, Hh, Hh, Mm, Mm^Xm, Hh, Md, Mm^Xm, Mm^Xm, Mm^Xm, Mm^Xm, Mm, Mm^Xm, Mm^Xm, Mm^Xm, Gg, Gg, Mm, Gg^Es, Mm^Xm, Mm^Xm, Mm^Xm, Mm^Xm, Mm^Xm, Mm^Xm, Mm^Xm
Gg, Hh, Gg^Efm, Mm, Wo, Mm, Ww, Wo, Wo, Ww, Mm, Mm, Mm, Rb, Hh, Mm, Mm, Hh^Fp, Hh, Mm, Mm, Gg, Hh, Mm, Mm^Xm, Hh, Gg, Gg, Gg, Hh, Gg, Hh, Hh, Hh, Hh, Hh, Gg, Gg, Hh, Gg, Gg, Hh, Gg, Hh, Hh, Gg
Gg, Hh, Ww, Wo, Ww, Ww, Wo, Wo, Ww, Wo, Mm, Mm, Mm, Re, Re, Gg^Efm, Gg, Mm, Mm, Mm, Hh, Gg, Gg, Mm, Mm^Xm, Hh, Hh, Hh, Hh, Gg, Hh, Gg, Hh, Hh^Fp, Mm, Gg, Gg, Hh, Mm, Mm, Hh, Gg, Hh, Gg, Gg, Gg
