border_size=1
usage=map

Qlf         , Urb         , Qlf         , Uue         , Uh          , Qlf         , Qlf         , Qlf         , Uue         , Qlf         , Uue         , Uue         , Uue         , Uh          , Uu          , Xue         , Mm          , Gg          , Gg          , Mm          , Mm          , Mm          , Mm          , Mm          , Hh          , Hh          , Gll^Fp      , Hh          , Gg          , Gg          , Gg          , Gg          , Gll^Fp      , Gg          , Gs^Fms      , Gg          , Gg          , Gs^Fms      , Gg          , Gg          
Qlf         , Qlf         , Uue         , Qlf         , Uue         , Uue         , Uue         , Uue         , Uue         , Uh          , Uue         , Uh          , Uue         , Uue         , Xue         , Xue         , Mm          , Mm          , Hh          , Mm          , Hh          , Mm          , Mm          , Mm          , Hh          , Gg          , Gll^Fp      , Hh          , Hh          , Hh          , Gll^Fp      , Gll^Fp      , Gg          , Gll^Fp      , Gs^Fms      , Gs^Fms      , Gs^Fms      , Gs^Fms      , Gg          , Gs^Fms      
Uue         , Uue         , Uue         , Qlf         , Qlf         , Uh          , Uue         , Qlf         , Uu          , Uue         , Xue         , Xue         , Xue         , Xue         , Hh          , Mm          , Mm          , Mm          , Hh          , Hh          , Hh          , Gg          , Hh          , Gll^Fp      , Gg          , Gll^Fp      , Gg          , Hh          , Gg          , Gs          , Gg          , Gll^Fp      , Gs^Fms      , Gg          , Gs          , Gg          , Gs^Fms      , Gg          , Hh^Fp       , Gg          
Qlf         , Uue         , Uh          , Qlf         , 1 Qlf       , Qlf         , Uue         , Uue         , Xuce        , Xue         , Hh          , Hh^Fp       , Hh          , Mm          , Hh          , Gg          , Hh          , Gg          , Hh^Fp       , Gg          , Gs          , Hh          , Gg          , Hh          , Gg^Es       , Gs          , Gs          , Gs^Fms      , Gll^Fp      , Gg          , Gs          , Gs          , Gg          , Gll^Fp      , Gg          , Gs          , Gs^Fms      , Gg          , Gs          , Gs^Fms      
Uh          , Uue         , Uue         , Qlf         , Qlf         , Qlf         , Urb         , Xue         , Hhd^Fdw     , Hhd^Fdw     , Hh          , Hhd^Fdw     , Gg^Es       , Hh          , Gg          , Hh^Fp       , Gg          , Hh          , Gll^Fp      , Hh^Fp       , Gg^Es       , Gs^Fms      , Gll^Fp      , Gs^Fms      , Gs^Fms      , Gs          , Gs^Fms      , Gg          , Gs^Fms      , Gs^Fms      , Gs^Fms      , Gg          , Gs          , Gs          , Gs^Fms      , Gs^Fms      , Gg          , Gs          , Gg          , Gs^Fms      
Uue         , Uue         , Uu          , Uh          , Uue         , Uu          , Xue         , Urb         , Gd          , Gs          , Hh^Fp       , Hhd^Fdw     , Hh^Fp       , Hhd^Fdw     , Hh^Fp       , Gg          , Gs          , Gs          , Gs          , Gd^Fdf      , Gs^Fms      , Gs^Fms      , Gg          , Gll^Fp      , Gs^Fms      , Gg          , Gs^Fms      , Gs^Fms      , Gs^Fms      , Gg          , Gg          , Gs^Fms      , Gll^Fp      , Gs^Fms      , Gg          , Gs^Fms      , Gg          , Gg          , Gs^Fms      , Gg          
Qlf         , Qlf         , Uue         , Uue         , Uue         , Uh          , Xue         , Hhd^Fdw     , Gd^Es       , Hhd^Fdw     , Hh          , Hh          , Gg          , Hh^Fp       , Gg          , Gg          , Hh^Fp       , Gg          , Gs^Fms      , Gll^Fp      , Gs^Fms      , Gg          , Gs^Fms      , Gs^Fms      , Gll^Fp      , Gg          , Gg          , Gg          , Gs          , Gg          , Gll^Fp      , Gs^Fms      , Gs^Fms      , Gg          , Gs^Fms      , Gs^Fms      , Gs^Fms      , Gs^Fms      , Gg          , Gg          
Uue         , Qlf         , Qlf         , Uh          , Uue         , Xue         , Gg          , Hh          , Gs          , Gd          , Gg          , Gs          , Gg          , Gs^Fms      , Gs^Fms      , Gs^Fms      , Gg          , Gll^Fp      , Gg          , Gg          , Gg          , Gs^Fms      , Gs^Fms      , Gg          , Gs^Fms      , Gs^Fms      , Gs^Fds      , Gs          , Gg          , Hh^Fp       , Gll^Fp      , Gg          , Gs^Fms      , Gg          , Gg          , Gs^Fms      , Gg          , Hh^Fp       , Gg          , Gs^Fms      
Wo          , Uue         , Uh          , Uue         , Uue         , Xue         , Gg          , Hhd^Fdw     , Hhd^Fdw     , Gs          , Gs^Fms      , Gs^Fms      , Gs^Fms      , Gs^Fms      , Gg          , Gll^Fp      , Gs^Fms      , Gs^Fms      , Gll^Fp      , Gg          , Gg          , Hh^Fp       , Gg          , Gg          , Gg          , Gs^Fms      , Gs^Fms      , Gs^Fms      , Gg          , Gll^Fp      , Gg          , Gs^Fms      , Gs^Fms      , Gll         , Gg          , Gs^Fms      , Hh^Fp       , Hh^Fp       , Gs^Fms      , Gg          
Uue         , Wo          , Xue         , Xue         , Xue         , Xue         , Gg          , Gg          , Gs^Fms      , Gs^Fms      , Gg          , Gg          , Hh^Fp       , Gg          , Gg          , Gs^Fms      , Gg          , Gs^Fms      , Gs^Fms      , Gg          , Gs^Fms      , Gg          , Gll^Fp      , Gs^Fms      , Gs^Fds      , Gll^Fp      , Gs^Fms      , Gll^Fp      , Gs^Fms      , Gg          , Gs^Fms      , Gg          , Gg          , Gll         , Gs^Fms      , Gs^Fms      , Gll         , Gg          , Gg          , Gg          
Xue         , Xue         , Mm          , Mm          , Hh^Fp       , Hh          , Gg          , Hhd^Fdw     , Gs^Fms      , Gs          , Gs          , Gs          , Gs^Fms      , Gg          , Hh^Fp       , Gg          , Gg          , Gg          , Gg          , Hh^Fp       , Gs^Fms      , Gll^Fp      , Gs^Fms      , Gg          , Gs^Fds      , Gg          , Gg          , Gll^Fp      , Gs^Fms      , Gg          , Gs^Fms      , Gs^Fms      , Gs^Fms      , Gg          , Gs^Fms      , Gg          , Gs          , Gg          , Gg          , Hh^Fp       
Mm          , Wo          , Wo          , Mm          , Gg^Efm      , Hh          , Gg          , Gs          , Gg          , Gs          , Gs          , Gg          , Gs^Fms      , Gg          , Gg          , Gs^Fms      , Gg          , Gg          , Gg          , Gs^Fms      , Gs^Fms      , Gll^Fp      , Gg          , Gg          , Gll^Fp      , Gs^Fms      , Gs^Fms      , Gll^Fp      , Gg          , Gg          , Gg          , Gs^Fms      , Gs^Fms      , Gs^Fms      , Gg          , Gg          , Gg          , Gs^Fms      , Gs^Fms      , Gg          
Mm          , Hh          , Ww          , Mm          , Hh          , Hh          , Hh          , Gg          , Gs          , Gs          , Gg          , Hh^Fp       , Gs^Fms      , Gll^Fp      , Gs^Fms      , Gs^Fds      , Gg          , Gs^Fms      , Gll^Fp      , Gg          , Gll^Fp      , Gg          , Gs^Fms      , Gs^Fms      , Gll^Fp      , Gg          , Gll^Fp      , Gg          , Gg          , Gs^Fms      , Gg          , Gg          , Gg          , Gs^Fms      , Gs^Fds      , Gll         , Gs^Fms      , Gs^Fms      , Gg          , Gg          
Hh          , Mm          , Wo          , Hh          , Hh          , Gg          , Hh          , Hh^Fp       , Gg          , Gg          , Gs^Fms      , Gs^Fms      , Gll^Fp      , Gll^Fp      , Gs^Fds      , Gll^Fp      , Gg          , Gs^Fms      , Gg          , Gg          , Gs^Fms      , Gs^Fms      , Gs^Fms      , Gll         , Gs^Fms      , Gs^Fms      , Gll         , Gg          , Gll^Fp      , Gg          , Gg          , Gs^Fms      , Gg          , Gg          , Gg          , Gs^Fms      , Gs^Fms      , Gs^Fms      , Gs^Fms      , Gs^Fms      
Hh          , Gg^Efm      , Hh          , Ww          , Gg          , Gg          , Gg          , Gg          , Gs^Fms      , Gs^Fms      , Gg          , Gg          , Gg          , Gg          , Gs          , Gs^Fms      , Gg          , Gs^Fms      , Gg          , Gg          , Gg          , Gs          , Gg          , Gs^Fms      , Gg          , Gs^Fms      , Gs          , Gs^Fds      , Gg          , Gg          , Gs^Fms      , Gg          , Gs^Fms      , Gs^Fms      , Gg          , Gg          , Gg          , Gg          , Gg          , Gg          
Ss          , Ss          , Gg          , Ww          , Wo          , Gg          , Gg          , Gg          , Gs^Fms      , Gs^Fms      , Gs^Fms      , Gg          , Gll^Fp      , Gs          , Gg          , Gs          , Gg          , Gg          , Gg          , Gs^Fds      , Gg          , Gg          , Gg          , Gs^Fms      , Gs^Fms      , Gs          , Gs^Fms      , Gg          , Gg          , Gs^Fms      , Gs^Fms      , Gg          , Gg          , Gg          , Gg          , Gg          , Gs^Fms      , Gs          , Gs^Fms      , Gg          
Gg          , Gg          , Gg          , Gg          , Gg          , Ww          , Gg          , Gg          , Gs          , Gg          , Gs^Fms      , Gll^Fp      , Gg          , Gll^Fp      , Gs^Fms      , Gs          , Gs          , Gs^Fms      , Gs^Fms      , Gs^Fms      , Gg          , Gg          , Gg          , Gg          , Gs          , Gg          , Gg          , Gll^Fp      , Gg          , Gs          , Gg          , Gs^Fms      , Gs^Fms      , Gs^Fms      , Gg          , Gs^Fms      , Gg          , Gs          , Gg          , Gg          
Ss          , Ss          , Ss          , Ss          , Gg          , Wo          , Ww          , Gg          , Gg          , Gg          , Gg          , Gg          , Gs^Fms      , Gs^Fms      , Gg          , Gs^Fms      , Gg          , Gg          , Gg          , Gs^Fms      , Gs^Fms      , Gs^Fms      , Gg          , Gs          , Gg          , Gg          , Gg          , Gg          , Gs          , Gs          , Gg          , Gg          , Gg          , Gg          , Gg          , Gg          , Gs          , Gs          , Gs          , Gg          
Sm          , Ss          , Gg          , Ss          , Ss          , Gg          , Wo          , Gg          , Gll^Fp      , Gg          , Gll^Fp      , Gs          , Gg          , Gg          , Gg          , Gg          , Gs^Fms      , Gg          , Gg          , Gg          , Gs^Fms      , Gg          , Gg          , Gg          , Gs          , Gs          , Gs          , Gg          , Gs          , Gg          , Gs          , Gg          , Gs          , Gg          , Gs          , Gs          , Gg          , Gg          , Gg          , Gg          
Gg          , Ss          , Gg          , Ss          , Ss          , Ss          , Wo          , Gg          , Gg          , Gll^Fp      , Gg          , Gs          , Gs          , Gg          , Gg          , Gs^Fms      , Gs^Fms      , Gg          , Gg          , Gg          , Gg          , Gs          , Gg          , Gg          , Gg          , Gs          , Gs          , Gg          , Gg          , Gg          , Gg          , Gs          , Gg          , Gs          , Gg          , Gg          , Gg          , Gg          , Gg          , Gg          
Gg          , Ss          , Ss          , Ss          , Gg^Efm      , Ss          , Ww          , Gg          , Gg          , Gg          , Gg          , Gg          , Gg          , Gg          , Gg          , Gs          , Gs          , Gg          , Gs          , Gg          , Gs          , Gg          , Gg          , Gg          , Gg          , Gg          , Gg          , Gs          , Gg          , Gg          , Gg          , Gg          , Gg          , Gg          , Rrc         , Rrc         , Rrc         , Rrc         , Rrc         , Rrc         
Ss          , Sm          , Gg          , Ss          , Ww          , Ww          , Ss          , Gg          , Gg          , Gg          , Gg          , Gg          , Gg^Efm      , Gg          , Gg          , Gs          , Gg          , Gg          , Gg          , Gg          , Gs          , Gs          , Gg          , Gg          , Gg          , Gg          , Gs          , Gg          , Gg          , Gg          , Gg          , Gg          , Rrc         , Rrc         , Ch          , Ch          , Ch          , Gg          , Gg          , Gg          
Gg          , Ss          , Gg^Efm      , Hh          , Wo          , Gg          , Gg          , Gg          , Gg          , Gg          , Gg          , Gg          , Gg          , Gg          , Gg          , Gs          , Gg          , Gg          , Gg          , Gs          , Gg          , Gg          , Gg          , Gg          , Gg          , Gg          , Gg          , Gg          , Gg          , Gg          , Rrc         , Rrc         , Gg          , Gg          , Gg          , 2 Kh        , Gg          , Gg          , Gg          , Gg^Vwm      
Ss          , Ss          , Ww          , Ww          , Gg          , Sm          , Ss          , Gg          , Ss          , Gg          , Ss          , Gg          , Gg          , Gg          , Gg          , Gg          , Gg          , Gg          , Gg          , Gs          , Gg          , Gg          , Gg          , Gg          , Gg          , Gg          , Gg          , Gg          , Rrc         , Rrc         , Gg          , Gg          , Gg          , Gg          , Rb^Gvs      , Gg          , Gs^Vc       , Gg          , Rb^Gvs      , Rb^Gvs      
Ww          , Wwf         , Gg          , Ss          , Gg          , Ss^Vhs      , Ss          , Gg^Efm      , Gg          , Ss          , Gg          , Gg          , Gg          , Gg          , Gg          , Gg          , Gg          , Gg          , Gg          , Gs          , Gg          , Gg          , Gg          , Gg          , Gg          , Gg          , Rrc         , Rrc         , Gg          , Gg          , Gg          , Gg          , Rb^Gvs      , Rb^Gvs      , Rb^Gvs      , Rb^Gvs      , Rb^Gvs      , Rb^Gvs      , Rb^Gvs      , Rb^Gvs      
Gg          , Sm          , Gg          , Ss          , Gg          , Ss          , Gg          , Gg          , Ss          , Ss          , Gg          , Ss          , Gg          , Gg          , Gg          , Gg          , Gg          , Gg          , Gg          , Gg          , Gg          , Gg          , Gg          , Gg          , Gg          , Rrc         , Gs^Vh       , Gg          , Gg          , Gg          , Rb^Gvs      , Rb^Gvs      , Rb^Gvs      , Rb^Gvs      , Rb^Gvs      , Rb^Gvs      , Rb^Gvs      , Rb^Gvs      , Rb^Gvs      , Rb^Gvs      
