border_size=1
usage=map

Gd          , Md          , Md          , Hhd         , Gd          , Gd          , Hhd         , Md          , Md          , Hhd         , Gd          , Gd          , Hhd         , Hhd         , Hhd         , Gd          , Gs          , Gd          , Gd          , Gd          , Hhd         , Md          , Md          , Hhd         , Gd          , Re          , Gd          , Gd^Edpp     , Gd          , Gd          , Gs          , Gd          , Rd          , Re          
Gd          , Hhd         , Md          , Hhd         , Hhd         , Hhd         , Md          , Md          , Hhd         , Hhd         , Gs          , Gs          , Hhd         , Md          , Gd          , Gd          , Gs          , Gs          , Hhd         , Hhd         , Hhd         , Md          , Hhd         , Hhd         , Gd          , Re          , Rd          , Gd          , Gd          , Gd^Edpp     , Gd          , Gd          , Rd          , Rd          
Hhd         , Hhd         , Hhd         , Hhd         , Hhd         , Md          , Hhd         , Hhd         , Hhd         , Hhd         , Md          , Hh          , Hhd         , Hhd         , Hhd         , Gd          , Hhd         , Gd          , Hhd         , Md          , Md          , Gd          , Hh          , Gd          , Gd          , Gd          , Gd          , Rd          , Re          , Gd          , Gd          , Gs          , Gd^Es       , Gs          
Gd          , Hhd         , Gd          , 1 Ke        , Ce          , Gd          , Hhd         , Gd          , Gs          , Gd          , Hhd         , Hhd         , Gs          , Gd          , Hhd         , Md          , Gd          , Rd          , Rb^Gvs      , Hhd         , Md          , Hhd         , Hhd         , Hhd         , Gd          , Gd          , Gg          , Gg          , Hhd         , Rd          , Rd          , Gd^Dr       , Gd          , Gd          
Gd          , Gd          , Hhd         , Ce          , Gd          , Hhd         , Gd          , Gs          , Gd          , Gd          , Gd          , Gd          , Gd          , Gd          , Gd          , Gs          , Gs          , Gd^Vhr      , Hhd         , Hhd         , Hhd         , Md          , Md          , Hh          , Hhd         , Hhd         , Hhd         , Hhd         , Hhd         , Hhd         , Gg          , Re          , Re          , Gd          
Gd          , Hhd         , Gd          , Gd          , Hhd         , Hhd         , Gd          , Gd          , Gd          , Gd^Edpp     , Gs          , Gd          , Gs          , Gd          , Gd          , Gd          , Gd          , Gd          , Gd          , Gd          , Gd          , Hh          , Gd          , Gd          , Gd          , Gg          , Gg          , Hhd         , Ce          , Hhd         , Hhd         , Hhd         , Rd          , Gd          
Gd          , Hhd         , Hhd         , Gs          , Gs          , Gd          , Gd          , Gd          , Gs          , Gd          , Gd          , Gd          , Gd          , Gd^Es       , Gd          , Gd          , Gd          , Gd          , Gd          , Gd          , Gd^Es       , Gd          , Gd          , Gd          , Hhd         , Hhd         , Hhd         , Ce          , 2 Ke        , Hhd         , Gd          , Gd          , Gd^Edpp     , Rd          
Gd          , Gd          , Gd^Edpp     , Gd          , Gd          , Gd          , Gd          , Gd          , Gd          , Gd          , Gd          , Gd          , Gd^Es       , Gd          , Gd          , Gs          , Hhd         , Gd          , Gd          , Gs          , Gd          , Gs          , Gd          , Gd          , Hhd         , Md          , Hh          , Md          , Gs          , Hhd         , Gg          , Hhd^Vhhr    , Hhd         , Gd^Es       
Gd          , Hhd         , Gd          , Gd          , Hhd         , Gd          , Rd          , Gd          , Gd          , Gd^Es       , Gd          , Gd          , Gd          , Gd          , Gd          , Hhd         , Hhd         , Gs          , Gs          , Gd          , Gs          , Gd          , Hhd         , Gd          , Hhd         , Md          , Hh          , Md          , Gs          , Hhd         , Hhd         , Gs          , Hhd         , Gs          
Gd          , Gd          , Hhd         , Gd          , Hhd         , Gd^Vhr      , Gd          , Gd          , Gd          , Gd          , Gs          , Gd          , Rd          , Gs          , Gd          , Gd          , Rd          , Gd^Vhr      , Hhd         , Gd          , Gd          , Gs          , Hhd         , Gs          , Hhd         , Hhd         , Mm          , Md          , Hhd         , Gd          , Hhd         , Gs          , Gs          , Gs          
Hhd         , Hhd         , Hhd         , Hhd         , Md          , Hhd         , Hhd         , Gd          , Gd          , Gd          , Gd          , Gd          , Gd          , Rd^Edp      , Gd          , Gs          , Hhd         , Gd          , Gd          , Hhd         , Hhd         , Gd          , Gd^Es       , Hhd         , Hhd         , Mm          , Hh          , Hhd         , Gd^Es       , Hhd         , Hhd         , Gs          , Hhd         , Gg          
Hhd         , Gd          , Md          , Md          , Md          , Md          , Gd          , Gs          , Gs          , Gs          , Gd          , Gd          , Gd          , Gd          , Gd          , Gd          , Gd          , Gd          , Gs          , Gd          , Hhd         , Gd          , Gd          , Gd          , Hhd         , Mm          , Mm          , Gd          , Gd^Es       , Gd          , Hh          , Hhd         , Hhd         , Hhd         
Md          , Mm          , Md          , Md          , Md          , Md          , Hhd         , Hhd         , Hhd         , Hhd         , Hhd         , Gd          , Gs          , Gd          , Gs          , Gd          , Gd          , Gd          , Gd          , Gd          , Gd          , Gd          , Gs          , Hhd         , Rd          , Hhd         , Hhd         , Md          , Md          , Gd          , Md          , Hhd         , Hhd         , Hhd         
Md          , Md          , Md          , Md          , Hhd         , Hhd         , Gd          , Gd          , Gd          , Gd          , Gd          , Gd          , Gd^Es       , Gd          , Gd          , Gd          , Rd          , Gd          , Gs          , Hhd         , Gd          , Gd          , Gd^Es       , Gs^Vh       , Rd          , Gd          , Gd          , Hh          , Hhd         , Hhd^Vhhr    , Md          , Md          , Hhd         , Hhd         
Mm          , Md          , Mm          , Hhd         , Gd^Es       , Gd^Es       , Gd          , Gd          , Gd          , Gd          , Gd          , Gs          , Gd          , Gd          , Gd          , Rd          , Rd^Edpp     , Rd^Es       , Gd          , Gd          , Gd          , Gd          , Gd          , Rd          , Gd          , Hhd         , Gd          , Hhd         , Hhd         , Md          , Gs          , Hhd         , Gd          , Hh          
Mm          , Mm          , Hhd         , Hhd         , Hhd         , Gs          , Gd          , Hhd         , Gd          , Gd^Es       , Gd          , Gd          , Gd          , Gs          , Gd          , Rd          , Rd          , Rd^Gvs      , Gd          , Gd          , Gd          , Gd^Es       , Gd          , Gs          , Gd          , Hhd         , Hhd         , Md          , Md          , Gg          , Gs          , Gd          , Gd^Es       , Gd          
Mm^Xm       , Hhd         , Hhd         , Hhd         , Gd          , Gd          , Hhd         , Hhd         , Gd          , Gd          , Gs          , Gd          , Gd          , Gd          , Gd          , Gd^Vhr      , Gd          , Gd          , Gd          , Gd          , Gd          , Gd          , Gd          , Gd          , Gd          , Gd          , Hhd         , Md          , Gd          , Gs          , Gs          , Gg          , Hh          , Gd          
Hh          , Md          , Md^Xm       , Hhd         , Gs          , Gs          , Hhd         , Gd^Vhr      , Rd          , Rd^Es       , Rd          , Gd          , Gd          , Gd          , Gd          , Gd          , Gd          , Gd          , Gd          , Gd^Es       , Gd          , Gd          , Gd          , Gd          , Gd          , Gd          , Gd          , Hhd         , Hhd         , Gg          , Gd^Es       , Gd          , Hh          , Gd          
Hh          , Mm          , Md^Xm       , Hhd         , Hhd         , Hhd         , Gd          , Gd          , Gd          , Gd          , Gs          , Gd          , Gd          , Gs          , Gd^Es       , Gd          , Gd          , Gd          , Gd          , Gs          , Gd          , Gd          , Gs          , Gs          , Gd          , Gd          , Gd          , Hhd         , Hhd         , Hhd         , Gd^Edpp     , Hh          , Hhd^Vhhr    , Hh          
Gs          , Mm          , Mm          , Md^Xm       , Md^Xm       , Hhd         , Gd          , Gd          , Gd          , Gd          , Gd          , Gd          , Gd          , Gs          , Gd          , Gd          , Gd          , Gd          , Gd          , Gd          , Gd          , Rb^Gvs      , Rb^Gvs      , Gd          , Gs          , Gd          , Gd          , Hh          , Hh          , Hh          , Gd          , Hh          , Re          , Re          
Gs          , Hh          , Gg          , Gs          , Mm          , Hh          , Hhd         , Gd          , Gs          , Gs          , Gs          , Gd          , Gd^Es       , Gd          , Gd          , Gd          , Gd          , Rd          , Rd          , Gd          , Gd          , Rb^Gvs      , Gd^Vhr      , Gs          , Rd          , Gd          , Gd          , Gd          , Ce          , Hhd         , Re          , Rd          , Hh          , Hh          
Gs          , Hh          , Gs^Es       , Gs          , Md          , Mm^Xm       , Gs          , Hhd         , Gs          , Gs          , Gs          , Gd          , Gd          , Gd          , Gs          , Gd          , Gs          , Gd^Vhr      , Gd          , Gd          , Gs          , Gd          , Rd          , Rd          , Gd          , Rd          , Rd          , Rd          , Ce^Dr       , Ce          , Hh          , Hh          , Mm          , Mm          
