border_size=1
usage=map

Rd          , Gs^Fms      , Ww          , Gg          , Gg          , Gs^Fms      , Gs^Fms      , Gs^Fms      , Gs^Fp       , Gs^Fms      , Gs^Fms      , Gs^Fms      , Gs^Fp       , Gs^Fms      , Gs^Fms      , Gs^Fms      , Gs^Fms      , Gs^Fms      , Gs^Fms      , Gs^Fms      , Gs^Fp       , Gs^Fp       , Gs          , Rd          , Gg          , Rd          , Gs^Fms      , Gs^Fms      , Gs^Fds      , Gs^Fms      , Gs^Fms      , Gs^Fms      , Gs^Fms      , Gs^Fms      , Gs^Fms      , Gs^Fms      , Gs^Fms      , Gs^Fms      
Gg          , Rd          , Gg^Efm      , Ww          , Ce          , Gs^Fms      , Ce          , Gs^Fms      , Gs^Fms      , Gs^Fms      , Gs^Fms      , Gs^Fms      , Gs^Fms      , Gs^Fms      , Gs^Fms      , Gs^Fms      , Gs^Fms      , Gs^Fp       , Gs^Fms      , Gs^Fds      , Gs^Fds      , Gs^Fds      , Gs^Fds      , Gs^Fms      , Gs^Fms      , Gs^Fms      , Gs^Fms      , Gs^Fms      , Gs^Fds      , Gs^Fms      , Gs^Fds      , Gs^Fms      , Gs^Fms      , Gs^Fp       , Gg^Ve       , Gs^Fms      , Gs^Fms      , Gs^Fms      
Gs^Fms      , Rd          , Ww^Bw\      , Ww          , Ce          , Ke          , Ce          , Gs^Fms      , Gs^Fms      , Gg^Ve       , Gg          , Gs^Fms      , Gs^Fms      , Gs^Fds      , Gs^Fms      , Gg^Efm      , Gs^Fms      , Gs^Fms      , Gs^Fp       , Gs^Fds      , Gs^Fds      , Gg          , Gs^Fms      , Gs^Fp       , Gs^Fms      , Gs^Fms      , Gs^Fp       , Gs^Fms      , Gg^Efm      , Gs^Fms      , Gs^Fms      , Gg          , Gs^Fms      , Gs^Fp       , Gs^Fms      , Hh^Fms      , Hh^Fds      , Gs^Fms      
Gs^Fms      , Gs^Fds      , Ww          , Rd          , Rd          , Ce          , Gg^Efm      , Gg          , Gs^Fms      , Gs^Fms      , Gs^Fms      , Gs^Fms      , Gs^Fms      , Gs^Fds      , Gs^Fms      , Gg          , Gs^Fms      , Gs^Fms      , Gg^Ve       , Gs^Fms      , Gs          , Gs          , Gs^Fms      , Gs^Fms      , Gs^Fms      , Gs^Fds      , Gs^Fmw      , Gs^Fp       , Gs^Fms      , Hh^Fds      , Gs^Fp       , Gs^Fms      , Hh^Fms      , Hh^Fp       , Hh^Fmw      , Hh^Fms      , Hh          , Hh          
Gs^Fms      , Gs^Fms      , Gs^Fms      , Ww          , Rd          , Gg^Ve       , Gs^Fms      , Gs^Fms      , Gs^Fms      , Gs^Fms      , Gs^Fp       , Gs^Fmw      , Gs^Fms      , Gg^Ve       , Gs^Fms      , Gs^Fds      , Gs^Fms      , Gs^Fms      , Gs          , Gs^Fms      , Gs^Fms      , Gs^Fms      , Gs^Fms      , Gs^Fms      , Gs^Fmw      , Gs^Fp       , Gs^Fms      , Gs^Fds      , Hh^Fds      , Gs^Fms      , Hh^Fp       , Hh^Fp       , Hh^Vhh      , Hh^Fms      , Hh          , Hh^Fms      , Hh^Fms      , Hh          
Gs^Fms      , Gs^Fp       , Gs^Fms      , Ww          , Gg          , Rd          , Gs^Fds      , Gs^Fms      , Gs^Fms      , Gs^Fms      , Gs^Fms      , Gs^Fds      , Gs^Fms      , Gs^Fp       , Gs^Fp       , Gs^Fds      , Gs^Fms      , Rd          , Chr         , Chr         , Ch          , Gs^Fms      , Gs^Fms      , Gs^Fds      , Gs^Fms      , Gs^Fms      , Gs^Fms      , Gs^Fms      , Gs^Fms      , Hh^Fms      , Gs^Fms      , Hh^Fms      , Ce          , Hh          , Hh          , Hh^Fms      , Hh          , Hh          
Gs^Fms      , Gs^Fds      , Gs^Fms      , Ww          , Gs^Fms      , Rd          , Gg          , Gs^Fp       , Gs^Fms      , Gg^Efm      , Gs^Fms      , Gs^Fms      , Gs^Fms      , Gs^Fms      , Gs^Fp       , Gs^Fms      , Gs^Fds      , Gs          , Chr         , 1 Khr       , Chr         , Gs^Fms      , Gs^Fds      , Gs^Fms      , Gg^Vc       , Gg^Efm      , Gg^Efm      , Gs^Fms      , Gs^Fms      , Hh^Fmw      , Hh^Fms      , Ce          , Ke          , Hh^Fmw      , Hh^Fmw      , Hh          , Mm^Vhh      , Mm          
Gs^Fms      , Gs^Fmw      , Gs^Fms      , Ww          , Ww          , Rd          , Rd          , Gg          , Rd          , Gs^Fms      , Gs^Fms      , Gs^Fms      , Gs^Fms      , Gg^Ve       , Gs^Fp       , Gs^Fms      , Gs^Fms      , Gs          , Rd          , Ch          , Gs^Fms      , Gs^Fms      , Gs^Fms      , Gs^Fms      , Gs^Fp       , Gs^Fms      , Gs^Fms      , Gs^Fms      , Gs^Fmw      , Hh^Fp       , Gs^Fms      , Ce          , Ce          , Ce          , Hh          , Mm          , Mm          , Mm          
Gs^Fms      , Gg          , Gs^Fms      , Gs^Fms      , Gs^Fms      , Ww          , Ww          , Rd          , Gs^Fp       , Rd          , Rd          , Rd          , Rd          , Gs^Fms      , Gs^Fms      , Gs^Fms      , Gs^Fp       , Gs^Fds      , Rd          , Gs^Fms      , Gs^Fms      , Gg^Ve       , Gs^Fds      , Gs^Fp       , Gs^Fms      , Gs^Fms      , Gs^Fds      , Gs^Fmw      , Gs^Fms      , Gs^Fms      , Ww          , Gs^Fms      , Ww          , Hh^Fms      , Ww          , Hh          , Hh          , Mm          
Gs^Fms      , Gs^Fms      , Gs^Fds      , Gs^Fms      , Gs^Fms      , Gs^Fms      , Gg          , Ww          , Gs^Fds      , Gs^Fms      , Gs^Fds      , Gg          , Rd          , Gs^Fms      , Rd          , Rd          , Rd          , Rd          , Gg          , Gs^Fms      , Gs^Fms      , Gs^Fms      , Ww          , Gs^Fms      , Ww          , Gs^Fms      , Gs^Fms      , Gs^Fds      , Gs^Fms      , Ww          , Gs^Fms      , Ww          , Hh^Fms      , Ww          , Hh^Fds      , Hh^Fms      , Mm          , Mm          
Gg          , Gg^Ve       , Gs^Fds      , Gs^Fp       , Gs^Fms      , Gg          , Gs^Fms      , Ww          , Ww          , Gg^Efm      , Ww          , Gs^Fms      , Gs^Fms      , Rd          , Ww          , Gg          , Gs^Fms      , Gs^Fms      , Gs^Fms      , Gg          , Gs^Fms      , Ww          , Gs^Fms      , Ww          , Gs^Fms      , Ww          , Ww          , Gs^Fms      , Ww          , Ww          , Hh^Fds      , Hh^Fp       , Hh^Fmw      , Hh^Fms      , Hh          , Hh          , Mm          , Mm          
Gs^Fms      , Gs^Fms      , Gs^Fms      , Gs^Fds      , Gs^Fms      , Gs^Fms      , Gs^Fms      , Gs^Fms      , Gs^Fms      , Ww          , Gs^Fms      , Ww          , Ww          , Wwf         , Rd          , Ww          , Ww          , Gs^Fds      , Ww          , Gs^Fms      , Wwr         , Wwr         , Gg          , Gs^Fp       , Gs^Fmw      , Gs^Fms      , Gs^Fms      , Ww          , Gs^Fms      , Gs^Fp       , Gs^Fms      , Hh^Fds      , Hh^Fp       , Hh^Fms      , Hh          , Mm          , Hh          , Mm          
Gs^Fms      , Gs^Fms      , Gg^Efm      , Gs^Fms      , Gg^Ve       , Gs^Fp       , Gs^Fms      , Gg          , Gs^Fms      , Gs^Fp       , Gs^Fds      , Gs^Fp       , Gs^Fms      , Gg          , Rd          , Gs^Fms      , Ww          , Ww          , Ww          , Ww          , Gs^Fms      , Gs^Fds      , Gs^Fds      , Gs^Fmw      , Gs^Fms      , Gg^Ve       , Gs^Fp       , Gs^Fms      , Gs^Fms      , Gg^Efm      , Gs^Fms      , Hh^Fms      , Hh^Fds      , Hh^Vc       , Hh          , Hh^Fms      , Hh          , Hh          
Gg          , Gs^Fds      , Gs^Fms      , Gs^Fms      , Gs^Fds      , Gs^Fms      , Gs^Fds      , Gs^Fms      , Gs^Fms      , Gs^Fms      , Gs^Fms      , Gs^Fms      , Gs^Fms      , Gs^Fms      , Gg          , Rd          , Rd          , Ww          , Ww          , Ww          , Ww          , Gs^Fp       , Ww          , Gg          , Gs^Fms      , Gs^Fms      , Gg          , Hh^Fp       , Gs^Fms      , Gs^Fp       , Hh^Fds      , Hh^Fp       , Hh^Fp       , Hh^Fp       , Hh^Fms      , Hh          , Ww          , Hh          
Gs^Fms      , Gs^Fds      , Gs^Fms      , Gs^Fms      , Gs^Fms      , Gs^Fds      , Gg^Efm      , Gg          , Gs^Fms      , Gs^Fms      , Gs^Fms      , Gg^Efm      , Gs^Fms      , Gs^Fms      , Gs^Fms      , Gg          , Rd          , Gs^Fds      , Gg^Vc       , Gs^Fds      , Gs^Fms      , Ww          , Gs^Fms      , Ww          , Ww          , Gs^Fds      , Wwr         , Gs^Fp       , Gs^Fds      , Gs^Fds      , Ww          , Gs^Fp       , Gs^Fms      , Hh^Fds      , Hh^Fms      , Ww          , Hh          , Hh          
Gg          , Gs^Fms      , Gs^Fms      , Gs^Fms      , Gs^Fds      , Gs^Fms      , Gg          , Gs^Fms      , Gs^Fms      , Gs^Fmw      , Gs^Fmw      , Gs^Fms      , Gg^Ve       , Gs^Fp       , Gs^Fms      , Gs^Fms      , Rd          , Rd          , Rd          , Rd          , Rd          , Gg          , Rd          , Ww          , Ww          , Ww          , Gs^Fms      , Ww          , Ww          , Ww          , Gs^Fms      , Ww          , Ww          , Ww          , Ww          , Ww          , Hh          , Mm          
Gg          , Gs^Fms      , Gs^Fms      , Gg          , Gg^Efm      , Gs^Fp       , Gs^Fms      , Gs^Fms      , Gs^Fms      , Gs^Fms      , Gs^Fms      , Gs^Fms      , Gs^Fms      , Gs^Fms      , Gs^Fms      , Gs^Fds      , Rd          , Gs^Fms      , Gs^Fms      , Gg          , Gg^Efm      , Rd          , Gg          , Rd          , Rd          , Rd          , Rd          , Gg^Efm      , Gg^Vh       , Gs^Fms      , Hh^Fp       , Gs^Fms      , Hh^Fms      , Hh^Fp       , Hh^Fms      , Hh^Fms      , Hh^Fms      , Hh          
Gg          , Gg          , Gg          , Gs^Fms      , Gs^Fms      , Gs^Fms      , Gg          , Gs^Fp       , Gs^Fms      , Gg          , Gs^Fms      , Gs^Fms      , Gs^Fds      , Gg          , Gs^Fms      , Rd          , Gg          , Gs^Fms      , Gs^Fp       , Gs^Fds      , Gs^Fms      , Gs^Fms      , Gs^Fms      , Gg^Efm      , Gs^Fms      , Gg          , Gg          , Rd          , Gg          , Hh^Fms      , Hh^Fp       , Hh^Fms      , Gs^Fms      , Hh^Fms      , Hh^Fp       , Hh          , Hh^Fms      , Hh^Fms      
Gg          , Gs^Fp       , Gs^Fms      , Gg          , Gs^Fms      , Gs^Fms      , Gs^Fms      , Gg          , Gg          , Gs^Fms      , Gs^Fms      , Gg^Efm      , Gg          , Gs^Fms      , Gs^Fms      , Rd          , Rd          , Gs^Fmw      , Gs^Fms      , Gs^Fms      , Gs^Fp       , Gs^Fms      , Gs^Fms      , Gs^Fms      , Gs^Fds      , Gs^Fms      , Gs^Fms      , Rd          , Rd          , Gg          , Rd          , Gs^Fms      , Gg          , Gs^Fms      , Gg^Efm      , Gs^Fms      , Gs^Fms      , Hh^Fmw      
Gs^Fms      , Gs^Fms      , Gs^Fms      , Gs^Fp       , Gg          , Gg          , Gs^Fds      , Gg          , Gs^Fms      , Gs^Fms      , Gg          , Gs^Fmw      , Gs^Fms      , Gs^Fms      , Gs^Fp       , Gg          , Rd          , Gs^Fms      , Gs^Fp       , Gs^Fds      , Gs^Fms      , Gs^Fms      , Gg^Efm      , Gs^Fms      , Gs^Fms      , Gs^Fds      , Gs^Fms      , Gg          , Gg          , Rd          , Gg          , Rd          , Rd          , Rd          , Rd          , Gs^Fmw      , Gs^Fms      , Gs^Fms      
Gs^Fms      , Gg          , Gg          , Gg^Efm      , Gg          , Gs^Fms      , Gs^Fds      , Gs^Fms      , Gs^Fms      , Gs^Fms      , Gg          , Gs^Fms      , Gs^Fp       , Gs^Fms      , Gg^Ve       , Rd          , Gg          , Gs^Fms      , Gs^Fms      , Gg          , Gg          , Gg^Ve       , Gs^Fms      , Gs^Fms      , Gs^Fp       , Gs^Fms      , Gs^Fms      , Gg          , Gg^Efm      , Gs^Fds      , Gs^Fms      , Gs^Fms      , Gs^Fms      , Gg          , Rd          , Gg          , Gg          , Gs^Fms      
Gs^Fms      , Gs^Fms      , Gg          , Gg          , Gg          , Gs^Fds      , Gs^Fms      , Gg          , Gs^Fds      , Gs^Fms      , Gs^Fms      , Gs^Fms      , Gs^Fms      , Gs^Fms      , Rd          , Rd          , Gs^Fmw      , Gs^Fms      , Gg^Efm      , Gs^Fms      , Gs^Fms      , Gs^Fp       , Gs^Fds      , Gs^Fms      , Gs^Fms      , Hh^Fms      , Hh          , Gs^Fms      , Hh^Fds      , Gs^Fds      , Hh^Vhh      , Hh^Fmw      , Hh^Fp       , Gs^Fms      , Gg          , Rd          , Gg          , Gg          
Gg          , Gg          , Gg          , Gs^Fms      , Gg          , Gg          , Gg^Efm      , Gg          , Gs^Fms      , Gs^Fms      , Gg^Efm      , Gs^Fms      , Gs^Fds      , Gg          , Rd          , Gs^Fms      , Gs^Fms      , Gs^Fms      , Gs^Fms      , Gs^Fms      , Gs^Fds      , Gs^Fms      , Gs^Fp       , Hh^Fds      , Gs^Fms      , Hh^Fms      , Hh^Fms      , Hh^Fms      , Hh^Fms      , Hh^Fms      , Hh^Fp       , Hh^Fms      , Hh^Fms      , Hh^Fms      , Hh^Fms      , Rd          , Gs^Fms      , Gg          
Gg          , Gg^Efm      , Gg          , Gs^Fms      , Ce          , Gg          , Gs^Fms      , Gg          , Gs^Fms      , Gg^Efm      , Gg          , Gs^Fp       , Gg          , Rd          , Gs^Fms      , Gg          , Gs^Fp       , Gs^Fds      , Gg          , Gs^Fms      , Gs^Fds      , Gs^Fds      , Gs^Fms      , Gs^Fds      , Hh^Fp       , Gs^Fms      , Gs^Fms      , Hh^Fms      , Gs^Fms      , Hh^Fp       , Hh^Fms      , Hh          , Hh^Fms      , Hh^Fms      , Gs^Fms      , Rd          , Rd          , Gg          
Gs^Fp       , Gg          , Gs^Fms      , Ce          , Ke          , Ce          , Gg          , Gg^Ve       , Gg          , Gg          , Gg          , Gg          , Rd          , Rd          , Gg          , Gg          , Gs^Fms      , Gs^Fms      , Gs^Fms      , Gs^Fms      , Gg^Efm      , Gs^Fms      , Gs^Fms      , Gs^Fms      , Gs^Fms      , Gs^Fms      , Gs^Fms      , Gs^Fms      , Gs^Fms      , Hh^Fds      , Hh^Fp       , Hh          , Hh          , Hh^Fds      , Gs^Fds      , Gg          , Rd          , Gg          
Gs^Fms      , Gg          , Gg          , Ce          , Ce          , Ce          , Rd          , Rd          , Rd          , Rd          , Rd          , Rd          , Gg          , Gg          , Gg          , Gs^Fms      , Gs^Fp       , Gg          , Gs^Fms      , Gg^Efm      , Gs^Fms      , Gs^Fms      , Gs^Fds      , Gs^Fms      , Gs^Fms      , Gs^Fp       , Gs^Fds      , Hh^Fms      , Hh^Fp       , Hh^Fds      , Hh^Fms      , Hh          , Hh^Fms      , Hh          , Hh          , Gg          , Gg          , Rd          
Gg          , Gg^Efm      , Gg          , Gs^Fds      , Gg          , Rd          , Gg          , Gs^Fms      , Gg          , Gg          , Gg          , Gg          , Gs^Fms      , Gs^Fms      , Gg          , Gg^Efm      , Gg^Efm      , Gg          , Gs^Fms      , Gs^Fms      , Gs^Fms      , Gs^Fds      , Gs^Fms      , Gs^Fms      , Gg          , Gs^Fms      , Gs^Fp       , Gs^Fds      , Gs^Fp       , Gs^Fms      , Hh^Fds      , Hh          , Hh          , Hh          , Hh          , Hh^Fds      , Hh          , Gg          
Gg          , Gg          , Gg          , Gg          , Rd          , Rd          , Gg          , Gg^Efm      , Gg          , Gg          , Gg          , Gg          , Gs^Fms      , Gg          , Gg          , Gg^Efm      , Gg          , Gs^Fms      , Gg          , Gg          , Gs^Fms      , Gg          , Gs^Fms      , Gs^Fms      , Gs^Fms      , Gg          , Gg          , Gs^Fms      , Gs^Fms      , Gs^Fms      , Hh^Fp       , Hh^Fp       , Hh^Fp       , Hh          , Hh          , Hh          , Hh          , Gg          
