border_size=1
usage=map

Hh^Fp       , Md          , Ms^Xm       , Hh^Fp       , Hh^Vhh      , Hh^Fp       , Hh          , Mm          , Mm          , Ms          , Mm          , Hh          , Gg          , Ds          , Hh          , Hh          , Ss          , Ss          , Ss          , Ss          
Md          , Md          , Ms^Xm       , Ms^Xm       , Hh          , Hh^Fp       , Hh          , Mm          , Mm          , Ms          , Mm          , Hh          , Gg          , Ds          , Ss          , Ss          , Ds          , Gg^Efm      , Ss          , Gg          
Ms^Xm       , Md          , Ms^Xm       , Md          , Hh          , Gg^Efm      , Gg^Efm      , Gg^Efm      , Mm          , Mm          , Hh          , Hh          , Ss          , Gg          , Gg          , Ds          , Rb          , Re          , Gg          , Rb          
Md          , Ms^Xm       , Hh^Fp       , Gg^Efm      , Gs          , Gg          , Gs          , Mm          , Mm          , Mm          , Hh          , Ss          , Gg          , Ds          , Rb          , Ss          , Ss          , Ds          , Ds          , Ss          
Wo          , Md          , Hh          , Hh          , Gg          , Gg^Es       , Gs          , Hh          , Mm          , Mm          , Hh          , Gg          , Rb          , Rb          , Ds          , Ss          , Ww          , Ww          , Ww          , Ww          
Md          , Md          , Hh          , Hh          , Gs^Es       , Gs          , Gg          , Hh          , Mm          , Hh          , Gg          , Gg          , Rb          , Gg          , Ds          , Ss          , Ww          , Wot         , Wot         , Wot         
Md          , Md          , Md          , Gs          , Gg          , Gs          , Gg          , Gg          , Gg          , Gg          , Re          , Rb          , Gg          , Gg          , Ss          , Ss          , Wot         , Wot         , Hh          , Ss          
Hh          , Md          , Hh          , Gg          , Gg          , Gg          , Gs          , Gs          , Rb          , Gs          , Gg^Es       , Gg          , Ss          , Gg          , Gg^Efm      , Wot         , Wot         , Wot         , Wot         , Ss          
Gg          , Hh          , Gs          , Gs          , Gs          , Gg          , Rb          , 1 Re        , Gg          , Gg          , Ss          , Ss          , Gg^Efm      , Gg          , Ww          , Wwf         , Wot         , Wot         , Gg^Efm      , Hh          
Gg          , Gs          , Gs          , Gs^Es       , Gs          , Gg          , Gg          , Gg          , Gg          , Gg          , Ss          , Ds          , Gg          , Gg          , Ww          , Wot         , Ss          , Wwf         , Gg          , Hh          
Gg          , Gs          , Re          , Re          , Gg          , Gg          , Gg          , Gs          , Gg          , Ss          , Gg          , Ss          , Gg^Efm      , Ww          , Wot         , Wot         , Ww          , Ww          , Hh          , Hh          
Re          , Re          , Gs          , Gg          , Gs          , Gg^Efm      , Ss          , Gg          , Ss          , Gg          , Ds          , Ds          , Wot         , Wot         , Ww          , Ss          , Gg^Efm      , Ww          , Wwf         , Wwf         
Gg          , Gg          , Gg          , Gs^Es       , Gg          , Ds          , Ss          , Gg          , Ss          , Gg^Efm      , Ww          , Ww          , Wot         , Wot         , Ds          , Ss          , Mm          , Hh          , Mm          , Gg^Efm      
Gg          , Gg          , Ss          , Gg^Efm      , Ss          , Ss          , Ds          , Ss          , Ww          , Ww          , Ww          , Wot         , Wot         , Gg          , Hh          , Mm          , Mm          , Mm          , Ms^Xm       , Mm          
Ss          , Gg          , Ss          , Ss          , Gg^Efm      , Ds          , Ww          , Ww          , Wot         , Wot         , Wot         , Wot         , Hh          , Hh          , Hh          , Mm          , Ms^Xm       , Ms^Xm       , Ms^Xm       , Ms^Xm       
Ds          , Ss          , Sm          , Ds          , Ds          , Ww          , Wot         , Wot         , Gg^Efm      , Ss          , Ss          , Gg          , Hh          , Gg          , Hh          , Mm          , Ms          , Ms          , Ww          , Ms          
